11111111111111
1100000C000001
11000D00010001
1000C0P00E0001
10010000000101
1000100C000001
11111111111111
