0000011
0111111
010N010
01EPW10
010S010
1111110
0100001
