11111
10001
10001
1EPC1
11111
