1111111111111
100100CC00P01
10CC011111001
100011C0E0001
1111111111111
