1111111111111
100100CC00001
10CC011111001
1P0011C0E0001
1111111111111