11111111111111
1100000CC00CC1
1100000CC00C01
100CC0P0000001
1000000C000001
1000000CC00CE1
11111111111111
